Дискотека 80х
- Максим Леонидов - Девочка-видение
- Boney M - Rasputin
- Веселые Ребята - Уходило лето
- Земляне - Трава у дома

Кинематограф
- Джентельмены удачи
- У природы нет плохой погоды (Служебный роман)
- Кин-Дза-Дза
- В бой идут одни старики

Классическая классика
- Ричард Вагнер - Полет валькирий
- Моцарт - Симфония №40, часть 1
- Эдвард Григ - В пещере Горного Короля
- Иоганн Себастьян Бах - Токката и фуга ре минор

Ну это все знают
- PSY - Gangnam Style
- Yolanda be Cool - Papa Americano
- Michael Jackson - Billie Jean
- Пьер Нарцисс - Шоколадный Заяц

Танцевальная
- Александр Рыбак - Fairytale (Remix)
- Дискотека Авария - Пей Пиво
- Виктор Цой - Звезда по имени Солнце (Remix)
- Crazy Frog - Axel F

Особое место
- Игорь Корнелюк - Город, которого нет
- Britney Spears - Toxic
- Queen - We Will Rock You
- Joe Dassin - L'ete Indien